1111111111111
1000100000C01
1010001111J01
10P111E000001
1111111111111