1111111111111111111111
10010000000C0000000001
10J00111111111111111C1
1P0011E00000000C000001
1111111111111111111111
